border_size=1
usage=map

Gg, Gg, Gg, Gg, Gg, Gg, Gg, Gg, Gg, Gg, Gg, Gg, Gg, Gg, Gg, Gg, Gg, Gg, Gg, Gg, Gg, Gg, Gg, Gg, Gg, Gg, Gg, Gg, Gg, Gg, Gg, Gg, Gg, Gg, Gg, Gg, Gg, Gg, Gg, Gg, Gg, Gg, Gg, Gg, Gg, Gg
Gg, Gg, Gg, Gg, Gg, Gg, DlZ, DlZ, DlZ, Gg, Gg, Gg, Gg, Gg, MdaZ, Gg, Gg, Gg, Gg, Gg, Gg, Gg, Gg, Gg, Gg, Gg, Gg, Gg, CbsY, Gg, CbsY, Gg, Gg, Gg, Gg^YcZ, Gg, Gg, Gg, Gg, Gg, Gg, Gg, Gg, Gg, Gg, Gg
Gg, Gg, Gg, Gg, DlZ, DlZ, HlZ, MlZ, MlZ, DlZ, Gg, Gg, MdaZ, MdaZ, MdaZ, MdaZ, Ss^Vhso, Gg, Gs^Fto, Gg, Gg^QcnZ, Gg, Gg, Gg, Gg, CbsY, CbsY, CbsY, CbsY, CbsY, CbsY, CbsY, CbsY, CbsY, Gg^YcZ, Gg, Gg, Gg, Gg, Gg, Gg, Gg, Gg, Gg, Gg, Gg
Gg, Gg, Gg, DlZ, DlZ^DlcZ, DlZ, DlZ, MlZ, DlZ, DlZ, Gg, Gg, MdaZ, MdaZ, MdaZ^Xm, MdaZ, MdaZ, Sm, Gs^Fto, Gs^Ftd, Dd, Gg^QcnZ, Gg^QcsZ, Gg^QcsZ, Gg, Gg, CbsY, CbsY, KbsY, KbsY, KbsY, CbsY, CbsY, Gg^YcZ, Gg, Gg, Gg, Gg, Gg, Gg, Gg, Gg, Gg, Gg, Gg, Gg
Gg, Gg, Gg, DlZ, DlZ, DlZ, Gg, DlZ, DlZ, Gg, Gg, MdaZ^Xm, MdaZ, MdaZ, MdaZ, MdaZ, MdaZ, Ss, Sm, Dd, Dd^VdpY, Dd, Gg, Gg, Gg, Gg, CbsY, CbsY, CbsY, KbsY, CbsY, CbsY, CbsY, Gg^YcZ, Gg^YcZ, Gg, Gg, CtrY, CtrY, CtrY, CtrY, CtrY, Gg, Gg, Gg, Gg
Gg, Gg, Gg, Gg, Gg, Gg, Gg, Gg, Gg, Gg, Gg, MdaZ, Hd, Hd^Edpp, Dd, Wwf, Wwf, Wwf, Ww, Dd, Rdc, Rd, Gg, Gg, Gg, CbsY, Gg^YcZ, CbsY, CbsY, CbsY, CbsY, CbsY, Gg, CbsY, Gg^YcZ, Gg, Gg, CtrY, CtrY, KtrY, CtrY, CtrY, Gg, Gg, Gg, Gg
Gg, Gg, Gg, Gg, Gg, Gg, Gg, Gg, Gg, Gg, Hd^ShD, Hd^ShD, Hd, Dd, Dd^Ftd, Dd, Dd, Dd^Sob, Rdc, Ww^BaB/, Ww, Dd, Dd^Ftd, Gg, Gg, Gg, Gg^YcZ, Gg, Gg, CbsY, Gg, Gg, Gg^YcZ, Gg, Gs, Gg, Gg, CtrY, Gg, CtrY, Gg, CtrY, Gg, Gg, Gg, Gg
Gg, Gg, Gg, Gg, Gg, Gg, Gg, Gg, Gg, Gg, Hd^ShD, Hd^ShD, Hd, Dd, Dd, Dd^VdrY, Rdc, Rd, Dd^Sob, MdsY, MdsY, Ww, Wwfo, Ss, Gg, Gg, Gg, Gg^YcZ, Gg, Gg, Gs, Gg^YcZ, Gg^YcZ, Gg^YcZ, Gg, Gg, Gg, Gg, Gg, Gg, Gg, Gg, Gg, Gg, Gg, Gg
Gg, Gg, Gg, Gg, Gg, Gg, Gg, Gg, Gg, Gg, Gg, Hd, Dd, Dd^Ftd, Dd^VdrY, Rdc, Cdr, Cdr, Dd^Ftd, MdsY, MdsY, Ds, Ds, Wwfo, Wot, Gg, Gg, Gg^YcZ, Gg, Gs, Gg, Gg, Gg, Gg, Gg, Rr^VrhX, Rp, Gg, Gg, Gg, Gg, Gg, Gg, Gg, Gg, Gg
Gg, Gg, XowZ, Gg, XowZ, Gg, XowZ, Gg, XowZ, Gg, Gg, Gg, Dd, Dd, Dd, Rdc, Cdr, Rd, Dd^Do, Rd, Dd^Vdao, Ds^Edpp, Ds, Wwt, Wot, Wot, Ww, Gg, Gg, Gg, Gg, Gg, Gg, Gg, Ch, Rp, Rp, Ch, Ch, Gg, Ww, Gg, Gg, Gg, Gg, Gg
Gg, XowZ, Ur, XowZ, Ur, XowZ, Ur, XowZ, Ur, XowZ, Ur, Gg, Gg, Dd^Ftd, Gg, Gg, Gg, Dd, Rd, Rd, Rd, Ds, Wwt, Wwt, Wot, Wot, Wot, Ww, Ww, Gg, Ww, Gg, Gg, Ch, Rr^Vhco, Rr^Vhc, Rr, Rr^Vhco, Rr, Ww, Gg, Gg, Rr, Rr^FrhX, Gg, Gg
Gg, Ur, Ur, Ur, Ur, XowZ, Ur, XowZ, Ur, Ur, XowZ, Ur, Xos, Gg, Gg, Gg, Gg^QcsZ, Gg, Gg, Dd^Vdao, Ds, Ds^Bw\, Wwt, Wot, Wot, Wot, Wot, Wo, Wo^Vwss, Ww, Wo, Wo, Ww, Rr, Rr, Rp, Rr^FYrf, Rr, Rr^FrhX, Ww^Bsb\, Rr, Rr^FrhX, Rp, Rr, Rr, Gg
Gg, XowZ, XowZ, XowZ, Ur, Ur, XowZ, Ur, Ur, XowZ, XowZ, Ur, Xos, Gg, Gg, Gg, Gg, Gg^QcsZ, Gg, Gg, Gg, Wwt, Wot, Wot, Wot, Wot, Wot, Wo, Wo, Ww, Ww, Wo^Bw\, Wo^Bw\, Ww^Bw/, Ww, Rr, Ch, Kh, Rr^FrhX, Ww, Rr^FrhX, Rr, Rr, Rr^VrhX, Gg, Gg
Gg, Uu^Uf, XowZ, Ur, Ur, XowZ, XowZ, XowZ, Ur, Ur, XowZ, Ur, Xos, Gg, Gg, Gg^QcnZ, Gg^QcnZ, Gg, Gg^QcsZ, Gg^QcsZ, Wot, Wot, Wot, Wot, CmeZ, Wot, Wot, Wot, Wo, Wo, Wo, Wo, Wo, Wo^Bw\, Gg, Gg, Gg, Gg, Gg, Ww, Gg, Rr^FrhX, Gg, Gg, Gg, Gg
Uu, Uu, Uu, XowZ, Ur, Ur, Ur, Ur, Ur, XowZ, Uu^Uf, Ur, Gg, Gg, WufZ, Gg, Gg, Gg^QcsZ, Gg, Gg, Wot, Wot, Wwf, CmeZ, KmeZ, CmeZ, Wwf, Wot, Wo, Wo, Gg, Gg, CrpY, Gg, Gg, Gg, Gg, Gg, Gg, Gg, Gg, Gg, Gg, Gg, Gg, Gg
WuoZ, WuoZ, WuwZ, WufZ, Ur, XowZ, XowZ, XowZ, Ur, Gg, Gg, Gg, Gg, Gg^QcsZ, Gg^QcsZ, WufZ, Gg, Gg, Gg, Gg, Gg, Wwf, Wwfo, CmeZ, CmeZ, CmeZ, Wwfo, Wwf, Gg, Gg, Gg, CrpY, CrpY, CrpY, Gg, Gg, Gg, Gg, Gg, Gg, Gg, Gg, Gg, Gg, Gg, Gg
WuoZ, WuoZ, WuwZ, WufZ, WufZ, Ur, XowZ, Ur, ZwsL, Uue^VmbX, Gg, Gg, Gg, Gg, Gg^Epen, Gg, Gg^QcnZ, Gg^QcnZ, Gg, Gg, Wwf, Wwf, Wwfo, Wwfo, Wwfo, Wwfo, Wwf, Wwf, Gg, Gg, Gg, CrpY, CrpY, CrpY, Gg, Gg, Gg, Gg, Sm, Ss, Rb, Gg, Gg, Gg, Gg, Gg
WuoZ, WuoZ, WuoZ, WuwZ, WufZ, Uh, Xu, Uue^VmbX, Uue, Uue, Gg, Gg, Gg^Epen, Gg^Epen, Gg, Gg^Epen, Gg^Epen, Gg^QcnZ, Gg, Gg, Wwf, Wwfo, Wwfo, Wwfo, Wwfo, Wwfo, Wwf, Gg, Gg, Gg, Gg, Gg, Gg, Gg, Gg, Gg, Rb, Ss^SsmG, Ss, Ss^SsmG, Ss, Ss^Vhso, Gg, Gg, Gg, Gg
Uue, WuoZ, Uue, WuwZ, Uu, Uh, Xu, Gg, Gg, UheY, Gg, Gg, Gg, Gg^Epen, Gg^Epen, Gg^Epen, Gg, Gg, Gg, Gg, CmZ, CmZ, CmZ, CmZ, CmZ, Wwfo, Wwf, Gg, Gg, Gg, Gg, Gg, Gll, Gg, Gg, Gg, Ss^SsmG, Sm, Ss^FYsg, Rb, Gg, Gg, Gg, Gg, Gg, Gg
Xu, UheY, Xu, Uu, Xu, Xu, Gg, Gg, Gg, Gg, Gg, Gg, Gg, Gg, Gg, Gg, Gg, Gg, Gg, Gg, KmZ, KmZ, KmZ, CmZ, CmZ, Wwf, Gg, Gg, Gg, Gll^Fdf, Gll^VftH, Gll^Fmf, Gll, Gll^Fmf, Gll^Fdf, Gg, Gg, Ss, Ss, Ss, Gg, Gg, Gg, Gg, Gg, Gg
Gg, Xu, Gg, Xu, Gg, Gg, Gg, Gg, Gg, Gg, Gg, Gg, Gg, Gg, Gg, Gg, Wwf, Gg, Gg, Gg, KmZ, KmZ, KmZ, CmZ, Gg, Gg, Gg, Gg, Gg, Gll^Fdf, Gll, Gll, Gll, Gll^VftH, Gg, Gg, Gg, Gg, Gg, Gg, Gg, Gg, Gg, Gg, Gg, Gg
Gg, Gg, Gg, Gg, Ms, Gg, Gg, Gg, Gg, Gg, Gg, Gg, Gg, Gg, Wwf, Wwf, Wwf^Erf, Wwf, Wwf, Gg, Gg, Gg, Gg, Gg, Gg, Gg, Gg, Gg, Gg, Gll^Fmf, Gll, Gll^Fdf, Gll^Fmf, Gll, Gg^Fds, Gg^Fds, Gg^Fds, Gg, Gg, Gg, Gg, Gg, Gg, Gg, Gg, Gg
Gg, Ms, Ms, Ms, Ha, Ha, Ms, Ha, Ms, Gg, Gg, Gg, Gg, Wwf, Wwf, Wwf^Erf, Wwf^Erf, Wwf, Wwf, Wwf, Wwf, Gg, Gg, Gg, Gg, Gg, Re^Vpr, Gg, Gg, Gg, Gg, Gll^VftH, Gll, Gg, Gg, Gll^FYdf, Gg^Uf, Gg, Gg, Gg, Gg, Gg, Gg, Gg, Gg, Gg
Gg, Ms, Ms, Ms, Ms, Ms, Ha, Aa^VdY, Ms, Ms, Gg, Gg, Gg, Gg^Edik, Gg^Edik, Wwf^Erf, Wwf, Wwf, Wwf^Erf, Wwf^Erf, Wwf^Erf, Wwf, Gg, Gg, Re^Vpr, Re, Re^Ecf, Aa, Aa, Gg, Gg, Gll^Fdf, Gg, Gg, Gg^Uf, Gg, Gg, Gg, Gg, Gg, Gg, Gg, Gg, Gg, Gg, Gg
Gg, Ms, Ms, Ms, Ms, Ms, Aa^VdY, Ms, Ms, Ms, Gg, Gg, Gg, Gg, Gg, Gg^Edik, Gg^Edik, Wwf^Erf, Wwf^Erf, Wwf^Erf, Wwf^Erf, Wwf, Gg, Gg, Re, Re, Re, Aa^Vprs, Gg, Gg, Gg, Gg, Gg, Gg, Gg, Gg, Gg, Gg, CdwY, Gg, Gg, Gg, Gg, Gg, Gg, Gg
Gg, Gg, Ms, Ms, Ms, Ms, Ms, Ha, Aa, Aa, Aa, Gg, TYb, Gg, Gg, Gg, Gg, Gg^Edik, Gg^Edik, Wwf^Erf, Gg, Gg, Gg, Gd, Gd, Re, Gg, Gg, Gg, Gg, Gg, Gg, Gg, Gg, Gg, Gg, Gg, CdwY, KdwY, CdwY, Gg, Gg, Gg, Gg, Gg, Gg
Gg, Gg, Ms, Ms, Ms, Ms, Ms, Aa, CcrY, CcrY, CcrY, TYb, TYb, Gg, Gg, Gg^Edik, Gg, Gg, Gg, Gg^Edik, Gg, Gg, Gg, Gd^Vprr, Gg, Gg, Xos, Gg, Gg, Gg, Gg, Gg, Gg, Gg, Gg, Gg, Gg, CdwY, CdwY, CdwY, Gg, Gg, Gd, Gg, Gg, Gg
Gg, Gg, Gg, Ms, Ms, Ms, Gg, Aa, CcrY, KcrY, CcrY, TYb, TYb, Gg, Gg, Gg, Gg, Gg, Gg, Gg, Gg, Gg, Gg, Gg, Xol^Emo\, Xos, Iwr^EbyZ, Xol, Xol, Gg, Gg, Gg, Gg, Gg, Gg, Gg, Gg, Gg, Gg, Gg, Rb, Rb, Rb, Gs, Gs, Gg
Gg, Gg, Gg, Gg, Gg, Gg, Gg, Aa, Aa, CcrY, Aa, Aa, Gg, Gg, Gg, Gg, Gg, Gg, Gg, Gg, Gg, Gg, Xos, Xol^Emo\, Iwr, Iwr, Iwr^FgcX, Iwr, Iwr, Xos^Emo/, Xol^Emo/, Gg, Gg, Gg, Gg, Gg, Gg^FfyZ, Gg, Rb, Rb, ZwsL, ZwsL^Evbd, ZwsL, Rb, Gd, Gg
Gg, Gg, Gg, Gg, Gg, Gg, Gg, Gg, Gg, Aa, Gg, Gg, Gg, Gg, Gg, Gg, Gg, Gg, Gg, Gg, Xos, Xos, Iwr, Iwr^EbuZ, IcP, IcP^FgcX, IcP^FgcX, Iwr^FgcX, Iwr, Iwr, Iwr, Xol, Xos, Gg, Gg, Gg^FfyZ, Gg^FfyZ, Gg^FfyZ, Rb, ZwsL, ZwsL, ZwsL, ZwsL^Evbd, Rb, Gg, Gg
Gg, Gg, Gg, Gg, Gg, Gg, Gg, Gg, Gg, Gg, Gg, Gg, Gg, Rp, Gg, Gg^Emon, Gg, Rp, Gg, Gg, Gg, Xos, Xos, Iwr, Iwr, IcP, Iwr, Iwr, Iwr^TabY, Iwr^TabY, Iwr^FgcX, Iwr, Xos, Xos, Gg, Gg^FfyZ, Gg^FfyZ, Gg^FfyZ, Gg^FfyZ, ZwsL^Evbd, ZwsL, ZwsL, Rb, Gd, Gg, Gg
Gg, Gg, Gg, Gg, Gg, Gg, Gg, Gg, Gg, Gg, Gg, Gg, Gg, Gg, Gg^Emon, Rp, Gg^Emon, Gg, Gg, Gg, Gg, Gg, Gg, Xos, Xos, Iwr, Iwr^TabY, Iwr, Iwr, Iwr, Xos, Xos, Gg, Gg, Gg, Gg^FfyZ, Gg^FfyZ, Gg^FfyZ, Gg^FfyZ, Rb, Rb, ZwsL, Rb, Gd, Gg, Gg
Gg, Gg, Gg, Gg, Gg, Gg, Gg, Gg, Gg, Gg, Gg, Gg, Gg, Gg, Gg, Gg, Gg, Gg, Gg, Gg, Gg, Gg, Gg, Gg, Gg, Xos, Xos, Iwr, Xos, Rrc, Gg, Gg, Gg, Gg, Gg^FfyZ, Gg, Gg^FfyZ, Gg^FfyZ, Gg^FfyZ, Gg^FfyZ, Gg, Rb, Gg, Gg, Gg, Gg
Gg, Gg, Gg, Gg, Gg, Gg, Gg, Gg, Gg, Gg, Gg, Gg, Gg, Gg, Gg, Rp, Gg, Gg, Gg, Gg, Gg, Gg, Gg, Gg, Gg, Gg, Gg, Xos, Gg, Rr, Rr^FgcX, Gg, Gg, Gg, Gg, Gg, Gg, Gg^FfyZ, Gg, Gg, Gg^FfyZ, Gg, Gg, Gg, Gg, Gg
Gg, Gg, Gg, Gg, Gg, Gg, Gg, Gg, Gg, Gg, Gg, Gg, Gg, Gg, Gg, Gg, Gg, Gg, Gg, Gg, Gg, Gg, Gg, Gg, Gg, Gg, Gg, Gg, Gg, Gg, Gg, Gg, Gg, Gg, Gg, Gg^FfyZ, Gg, Gg, Gg, Gg^FfyZ, Gg, Gg, Gg, Gg, Gg, Gg
